%%%%%%%
%  P  %
%     %
%     %
%  G  %
%     %
%%%%%%%