%%%%%%%
%    P%
%     %
%G    %
%     %
%     %
%%%%%%%